{
    "groundTextureUrl": "./textures/parquet.jpg",
    "wallTextureUrl": "./textures/tijoloWall.jpg",
    "windowTextureUrl":"./textures/tijoloWallWindow.jpg",
    "doorTextureUrl":"./textures/doorTexture.jpg",
    "size": { "width": 22, "height": 10 },
    "map": [
        [3  ,  2,  3,  2,  2,  2,  3,  2,  2,  2,  2,  2,  2,  2,  3,  2,  2,  2,  3,  2,  2,  2,  1],
        [1  ,  0,  1,  0,  0,  0,  1,  0,  0,  0,  0,  0,  0,  0,  1,  0,  0,  0,  1,  0,  0,  0,  1],
        [1  ,  0,  1,  0,  0,  0,  1,  0,  3,  2,  2,  2,  1,  0,  1,  0,  0,  0,  1,  0,  0,  0,  1],
        [1  ,  0,  1,  0,  0,  0,  1,  0,  1,  0,  0,  0,  1,  0,  1,  0,  0,  0,  1,  0,  0,  0,  1],
        [3  ,  2,  1,  0,  0,  0,  1,  0,  1,  0,  0,  0,  1,  0,  1,  0,  0,  0,  1,  2,  2,  2,  1],
        [2  ,  0,  1,  0,  0,  0,  1,  0,  1,  0,  0,  0,  1,  0,  1,  0,  0,  0,  1,  0,  0,  0,  1],
        [3  ,  0,  1,  0,  0,  0,  1,  0,  1,  0,  0,  0,  1,  0,  1,  0,  0,  0,  1,  0,  0,  0,  4],
        [1  ,  0,  1,  0,  0,  0,  1,  0,  1,  0,  0,  0,  1,  0,  1,  0,  0,  0,  1,  0,  0,  0,  4],
        [1  ,  0,  2,  2,  2,  2,  0,  0,  1,  0,  0,  0,  1,  0,  2,  2,  2,  2,  0,  2,  2,  2,  5],
        [1  ,  0,  0,  0,  0,  0,  0,  0,  1,  0,  0,  0,  1,  0,  0,  0,  0,  0,  0,  0,  0,  0,  5],
        [2  ,  2,  2,  2,  2,  2,  2,  2,  2,  2,  2,  2,  2,  2,  2,  2,  2,  2,  2,  2,  5,  5,  0]
    ],
    "initialPosition": [5, 21],
    "initialDirection": 0.0,
    "bridges":[
        {
            "locationBridge":[5,22],
            "buildind":
                {
                    "code":"B",
                    "floor":2,
                    "inicialPosition":[2,10]
                }
        }
    ],
    "exitLocation": [0,0]
}
